You wake up in a Bedroom. You don't know the place or why are you here. Follow the riddles and find your way out.
Igra interaktivne fikcije
An Interactive Fiction by Iva Kozmac
Release 1 / Serial number 230106 / Inform 7 v10.1.2 / D

Bedroom
There is one bed, one desk and one chair. On the desk you can see the old Book about animals.

You can see Bedroom door here.

>Bug spray
That's not a verb I recognise.

>Bug spray
That's not a verb I recognise.

>take bug spray
Use it when you most need it.

>badroom door
That's not a verb I recognise.

>open bedroom door
You open Bedroom door.

>go to hallway
You can't see any such thing.

>go to Hallway
You can't see any such thing.

>look
Bedroom
There is one bed, one desk and one chair. On the desk you can see Bug spray and the old Book about animals.

You can see Bedroom door here.

>open bedroom door
That's already open.

>hallway
That's not a verb I recognise.

>go through bedroom door
Hallway
A long, narrow room, with one old wardrobe and one Black door with a Riddle on it. Riddle is: I can fly but I'm not a helicopter. I'm an insect but I'm not an ant. I'm yellow and black but I'm not a butterfly. I can sting but I'm not a wasp.

You can see Bedroom door and Black door here.

>open black door
You open Black door.

>open black door
That's already open.

>close black door
You close Black door.

>open black door
You open Black door.

>go through black door
Dinning room
In the room are a chest and a Key. In the Chest is Riddle about animal you need rescue. 

You can see Black door, Red door, Bee, Key and Chest (closed) here.

>enter dinning room
You can't see any such thing.

>see
That's not a verb I recognise.

>go through black door
Hallway
A long, narrow room, with one old wardrobe and one Black door with a Riddle on it. Riddle is: I can fly but I'm not a helicopter. I'm an insect but I'm not an ant. I'm yellow and black but I'm not a butterfly. I can sting but I'm not a wasp.

You can see Black door and Bedroom door here.

>go through black door
Dinning room
In the room are a chest and a Key. In the Chest is Riddle about animal you need rescue. 

You can see Black door, Red door, Bee, Key and Chest (closed) here.

>take key
Taken.

>Take a key
You already have that.

>unlock chest
What do you want to unlock Chest with?

>key
You unlock Chest.

>open chest
I'm colorful but I'm not a rainbow. I'm sometimes found on a shoulder but I'm not a bag strap. I have two legs but Im not an ostrich. I can talk but I'm not a person. I can fly but I'm not an airplane.

>open red door
You open Red door.

>go through red door
Kitchen
In the kitchen you can see big Kitchen table with some food and little conrol panel. Also, there is a lot of kitchen elements and a big Mirror.

You can see Red door, Mirror and a control panel here.

>use control panel
That's not a verb I recognise.

>switch control panel
Mirror is moving and reveal secret passage!

>go through mirror
Secret passage
You can't see what is at the end of the passage because it is dark.

You can see Mirror, Colorful door and a light switch here.

>turn of
You can't see any such thing.

>switch of
You can't see any such thing.

>switch on
What do you want to switch on?

>light switch
This dangerous act would achieve little.

>push light switch
Now you can see colorful in the end of secret passage.

>push light switch
You can't see anything again.

>push light switch
Now you can see colorful in the end of secret passage.

>go through mirror
Kitchen
In the kitchen you can see big Kitchen table with some food and little conrol panel. Also, there is a lot of kitchen elements and a big Mirror.

You can see Mirror, Red door and a control panel here.

>switch control panel
The Mirror closes again.

>switch control panel
Mirror is moving and reveal secret passage!

* * *

>go through mirror
Secret passage
You can't see what is at the end of the passage because it is dark.

You can see Mirror, Colorful door and a light switch here.

>push light switch
You can't see anything again.

>switch
What do you want to switch?

>light
What do you want to light?

>switch
What do you want to switch?

>light switch
This dangerous act would achieve little.

>push
What do you want to push?

>light switch
This dangerous act would achieve little.

* * *

>push light switch
Now you can see colorful in the end of secret passage.

>go in secret room
You can't see any such thing.

>open colorful door
You open Colorful door.

>go through colorful door
Secret room
Secret room is big room with a lot of things in it. There are some toys, cockroaches, big closets, two desks, some bags and one animal. If you want save animal, take a food and it will follow you.

You can see Colorful door, Seed mix, Carrot, Apple and Parrot here.

>open colorful door
That's already open.

>go through colorful door
Secret passage
You can't see what is at the end of the passage because it is dark.

You can see Colorful door, Mirror and a light switch here.

>go through colorful door
Secret room
Secret room is big room with a lot of things in it. There are some toys, cockroaches, big closets, two desks, some bags and one animal. If you want save animal, take a food and it will follow you.

You can see Colorful door, Seed mix, Carrot, Apple and Parrot here.

>ask
What do you want to ask Parrot for?

>parrot
You can't see any such thing.

>ask parrot
What do you want to ask Parrot for?

>parrot
(Parrot first taking Parrot)
Parrot has better things to do.

>what animal is it
That's not a verb I recognise.

>parrot
That's not a verb I recognise.

>ask
What do you want to ask Parrot for?

>what animal is it
You can't see any such thing.

>take seed mix
You choose the right food.

>carry seed mix
You already have that.

>take seed mix
You already have that.

>take
What do you want to take?

>take seed mix
You already have that.

>take seed mix
You already have that.

>drop seed mix
Dropped.

>take seed mix
You choose the right food.

>carry parrot
I don't suppose Parrot would care for that.

* * *

You wake up in a Bedroom. You don't know the place or why are you here. Follow the riddles and find your way out.
Igra interaktivne fikcije
An Interactive Fiction by Iva Kozmac
Release 1 / Serial number 230106 / Inform 7 v10.1.2 / D

Bedroom
There is one bed, one desk and one chair. On the desk you can see the old Book about animals.

You can see Bedroom door here.

>open bedroom door
You open Bedroom door.

>go through bedroom door
Hallway
A long, narrow room, with one old wardrobe and one Black door with a Riddle on it. Riddle is: I can fly but I'm not a helicopter. I'm an insect but I'm not an ant. I'm yellow and black but I'm not a butterfly. I can sting but I'm not a wasp.

You can see Bedroom door and Black door here.

* * *

>open black door
You open Black door.

>go through black door
Dinning room
In the room are a chest and a Key. In the Chest is Riddle about animal you need rescue. But first use something to put Bee to sleep or they will attack you.

You can see Black door, Red door, Bee, a Bug spray, Key and Chest (closed) here.

>use bug spray on bee
You aren't carrying the Bug spray.

>take bug spray
Taken.

>use bug spray on bee
You put Bee in sleep with the Bug spray. You can continue your action.

>take key
Taken.

>unlock chest
What do you want to unlock Chest with?

* * *

>go through red door
Kitchen
In the kitchen you can see big Kitchen table with some food and little conrol panel. Also, there is a lot of kitchen elements and a big Mirror.

You can see Red door, Mirror and a control panel here.

>use control panel
What do you want to use the control panel on?

>sitch
You can't see any such thing.

>switch
What do you want to switch?

>control panel
Mirror is moving and reveal secret passage!

>go through mirror
Secret passage
You can't see because its dark here. Turn on the light and continue your action.

You can see Mirror, Colorful door and a light switch here.

>push light switch
You can now see your way.

>open colorful door
You open Colorful door.

>go through colorful door
Secret room
Secret room is big room with a lot of things in it. There are some toys, cockroaches, big closets, two desks, some bags, old key and one animal. If you want save animal, take a food and it will follow you. You can only escape if you go through Back door.

You can see Colorful door, Back door, Old key, Seed mix, Carrot, Apple and Parrot here.

>take carrot
You choose wrong food, try again.

>drop carrot
Dropped.

>take seed mix
You are carrying the Parrot.

>take old key
Taken.

>unlock back door
What do you want to unlock Back door with?

>old key
You unlock Back door.

>open back door
You open Back door.

>go through back door
This is the end, you saved animal. Good job. 

    *** You can go back to reality. ***

Would you like to RESTART, RESTORE a saved game, QUIT or UNDO the last command?

* * *

You wake up in a Bedroom. You don't know the place or why are you here. Follow the riddles and find your way out.
Igra interaktivne fikcije
An Interactive Fiction by Iva Kozmac
Release 1 / Serial number 230106 / Inform 7 v10.1.2 / D

Bedroom
There is one bed, one desk and one chair. On the desk you can see the old Book about animals.

You can see Bedroom door here.

>take Bug spray
You can't see any such thing.

>Open Bedroom door
You open Bedroom door.

>Go through Bedroom door
Hallway
A long, narrow room, with one old wardrobe and one Black door with a Riddle on it. Riddle is: I can fly but I'm not a helicopter. I'm an insect but I'm not an ant. I'm yellow and black but I'm not a butterfly. I can sting but I'm not a wasp.

You can see Bedroom door and Black door here.

>open black door
You open Black door.

>got through black door
That's not a verb I recognise.

>go through black door
Dinning room
In the room are a chest and a Key. In the Chest is Riddle about animal you need rescue. But first use something to put Bee to sleep or they will attack you.

You can see Black door, Red door, Bee, a Bug spray, Key and Chest (closed) here.

>take key
Taken.

>open chest
It seems to be locked.

>unlock chest
(with Key)
You unlock Chest.

>key
That's not a verb I recognise.

>open chest
I'm colorful but I'm not a rainbow. I'm sometimes found on a shoulder but I'm not a bag strap. I have two legs but Im not an ostrich. I can talk but I'm not a person. I can fly but I'm not an airplane.

* * *

>go through red door
Kitchen
In the kitchen you can see big Kitchen table with some food and little conrol panel. Also, there is a lot of kitchen elements and a big Mirror.

You can see Red door, Mirror and a control panel here.

>use control panel
(on Key)
other instances of using here.

>switch contrl panel
You can't see any such thing.

>switch control panel
Mirror is moving and reveal secret passage!

>go thtough mirror
You can't see any such thing.

>go through mirror
Secret passage
You can't see what is at the end of the passage because it is dark.

You can see Mirror, Colorful door and a light switch here.

>push light witch
You can't see any such thing.

>push light switch
Now you can see colorful in the end of secret passage.

>open colorful
You open Colorful door.

>go through colorful oor
You can't see any such thing.

>go through colorful door
Secret room
Secret room is big room with a lot of things in it. There are some toys, cockroaches, big closets, two desks, some bags, old key and one animal. If you want save animal, take a food and it will follow you. You can oly escape if you go through Back door.

You can see Colorful door, Back door, Old key, Seed mix, Carrot, Apple and Parrot here.

>take seed mix
You are carrying the Parrot.

>drop seed mix
You aren't carrying the Parrot.

>take carrot
You choose wrong food, try again.

>take parrot
I don't suppose Parrot would care for that.

>drop parrot
Parrot is already here.

>drop carrot
Dropped.

>take carrot
You choose wrong food, try again.

* * *

>drop seed mix
You aren't carrying the Parrot.

>take parrot
I don't suppose Parrot would care for that.

>carry parrot
I don't suppose Parrot would care for that.

>take seed mix
You are carrying the Parrot.

* * *

>drop seed mix
You aren't carrying the Parrot.

>take seed mix
You are carrying the Parrot.

I beg your pardon?

>take old key
Taken.

* * *

>go through back door
This is the end, you saved animal. Good job. 

    *** You can go back to reality. ***

Would you like to RESTART, RESTORE a saved game, QUIT or UNDO the last command?

>restart
You wake up in a Bedroom. You don't know the place or why are you here. Follow the riddles and find your way out.
Igra interaktivne fikcije
An Interactive Fiction by Iva Kozmac
Release 1 / Serial number 230105 / Inform 7 v10.1.2 / D

Bedroom
There is one bed, one desk and one chair. On the desk you can see Bug spray and the old Book about animals.

You can see Bedroom door here.

>open badroom door
You can't see any such thing.

>bedroom door
That's not a verb I recognise.

>open Bedroom door
You open Bedroom door.

>go through Bedroom door
Hallway
A long, narrow room, with one old wardrobe and one Black door with a Riddle on it. Riddle is: I can fly but I'm not a helicopter. I'm an insect but I'm not an ant. I'm yellow and black but I'm not a butterfly. I can sting but I'm not a wasp.

You can see Bedroom door and Black door here.

>open black door
You open Black door.

* * *

>go through black door
Dinning room
In the room are a chest and a Key. In the Chest is Riddle about animal you need rescue. But first use something to put Bee to sleep or they will attack you.

You can see Black door, Red door, Bee, a Bug spray, Key and Chest (closed) here.

>take bug spray
Taken.